+------------------+
| |                |
| |  +------+   +--|
| |       | |      |
| +---+   | +---+  |
|         | |      |
|-----+   + +  +---|
|     |     |      |
|  +  +-----+      |
|  |  |            |
|  |  |   +--------|
|  |  +   |        |
|  |      |   +    |
|  +------+   | +--|
|  |          |    |
|  + +----+   +    |
|                  |
|-----+  +---------|
|                 0|
+------------------+